11,11
+++++s+++++
+     +   +
+++++ +++ +
+   +     +
+ + +++++ +
+ +       +
+++ +++ + +
+   +   + +
+ +++++++ +
+     +   +
+++++f+++++

